   WE                            textures/wolfenstein/grey_stone.xpm
NO      textures/wolfenstein/purple_stone.xpm



SO textures/wolfenstein/red_brick.xpm


EA textures/wolfenstein/wood.xpm

F      17,    38,     64


C 218, 234, 235


1111111111111111111111111
1000110000100000000000001
1000110000000000000000001
1000110000000000110001001
1000000000000000000000001
1000000000000000000000001
1000000000000000000000001
1000000000000000000000001
10000000000N0000000000001
1000000000000000000000001
1000000000000000000000001
1000000000000000000000001
1000000000000000000000001
1111111111111111111111111