NO textures/wolfenstein/grey_stone.xpm
SO textures/wolfenstein/purple_stone.xpm
WE textures/wolfenstein/red_brick.xpm
EA textures/wolfenstein/wood.xpm

F 220,100,0
C 225,30,0


111111111111111111111111111
100000000011000001110111111
111101111111110111000000101
111101111111110111010100001
110000001101010111000010001
10000000000000001100N010001
100000000000000011010010001
111111111100011101111000111
        110101111111111111
        1000000000110000000000001
        1011000001110000000000001
        1001000000000000000000001
        1011000001110000000000001
        1111111111111111111111111
