NO textures/wolfenstein/grey_stone.xpm
SO textures/wolfenstein/purple_stone.xpm
WE textures/wolfenstein/red_brick.xpm
EA textures/wolfenstein/wood.xpm

C 100,100,150
F 50,50,50

        1111111111111111111111111
        1000000000110000000000001
        101100000111000000000001
        1001000000000000000000001
11111111101100000111000000000001
100000000011000001110111111111111
11110111111111011100000010001
11110111111111011101010010001
110000001101010111000000D0W01
10000000D00000001100000010001
10000000010000001101010010001
1100000111010101111101111000111
11110111 1110101 101111010001
11111111 1111111 111111111111